{
  "map": [
    [6, 6, 2, 2, 2, 6, 6, 6, 6],
    [6, 6, 2, 4, 2, 6, 6, 6, 6],
    [6, 6, 2, 0, 2, 2, 2, 2, 6],
    [2, 2, 2, 1, 0, 1, 4, 2, 6],
    [2, 4, 0, 1, 3, 2, 2, 2, 6],
    [2, 2, 2, 2, 1, 2, 6, 6, 6],
    [6, 6, 6, 2, 4, 2, 6, 6, 6],
    [6, 6, 6, 2, 2, 2, 6, 6, 6],
    [6, 6, 6, 6, 6, 6, 6, 6, 6]
  ],
  "mario": {
    "x": 4,
    "y": 4
  },
  "target": [[3,1],[1,4],[6,3],[4,6]]
}