{
  "map": [
    [6, 2, 2, 2, 2, 2, 6, 6, 6],
    [6, 2, 3, 0, 2, 2, 2, 6, 6],
    [6, 2, 0, 1, 0, 0, 2, 6, 6],
    [2, 2, 2, 0, 2, 0, 2, 2, 6],
    [2, 4, 2, 0, 2, 0, 0, 2, 6],
    [2, 4, 1, 0, 0, 2, 0, 2, 6],
    [2, 4, 0, 0, 0, 1, 0, 2, 6],
    [2, 2, 2, 2, 2, 2, 2, 2, 6],
    [6, 6, 6, 6, 6, 6, 6, 6, 6]
  ],
  "mario": {
    "x": 2,
    "y": 1
  },
  "target": [[1,4],[1,5],[1,6]]
}