{
  "map": [
    [2, 2, 2, 2, 2, 6, 6, 6, 6],
    [2, 0, 0, 3, 2, 6, 6, 6, 6],
    [2, 0, 1, 1, 2, 6, 2, 2, 2],
    [2, 0, 1, 0, 2, 6, 2, 4, 2],
    [2, 2, 2, 0, 2, 2, 2, 4, 2],
    [6, 2, 2, 0, 0, 0, 0, 4, 2],
    [6, 2, 0, 0, 0, 2, 0, 0, 2],
    [6, 2, 0, 0, 0, 2, 2, 2, 2],
    [6, 2, 2, 2, 2, 2, 6, 6, 6]
  ],
  "mario": {
    "x": 3,
    "y": 1
  },
  "target": [[7,4],[7,3],[7,5]]
}