{
  "map": [
    [6, 2, 2, 2, 2, 6, 6, 6, 6],
    [2, 2, 0, 0, 2, 6, 6, 6, 6],
    [2, 0, 3, 1, 2, 6, 6, 6, 6],
    [2, 2, 1, 0, 2, 2, 6, 6, 6],
    [2, 2, 0, 1, 0, 2, 6, 6, 6],
    [2, 4, 1, 0, 0, 2, 6, 6, 6],
    [2, 4, 4, 5, 4, 2, 6, 6, 6],
    [2, 2, 2, 2, 2, 2, 6, 6, 6],
    [6, 6, 6, 6, 6, 6, 6, 6, 6]
  ],
  "mario": {
    "x": 2,
    "y": 2
  },
  "target": [[1,5],[1,6],[2,6],[3,6],[4,6]]
}