[
  {
    "map": [
      [6, 6, 2, 2, 2, 6, 6, 6, 6],
      [6, 6, 2, 4, 2, 6, 6, 6, 6],
      [6, 6, 2, 0, 2, 2, 2, 2, 6],
      [2, 2, 2, 1, 0, 1, 4, 2, 6],
      [2, 4, 0, 1, 3, 2, 2, 2, 6],
      [2, 2, 2, 2, 1, 2, 6, 6, 6],
      [6, 6, 6, 2, 4, 2, 6, 6, 6],
      [6, 6, 6, 2, 2, 2, 6, 6, 6],
      [6, 6, 6, 6, 6, 6, 6, 6, 6]
    ],
    "mario": {
      "x": 4,
      "y": 4
    },
    "target": [[3, 1], [1, 4], [6, 3], [4, 6]]
  },
  {
    "map": [
    [2, 2, 2, 2, 2, 6, 6, 6, 6],
    [2, 0, 0, 3, 2, 6, 6, 6, 6],
    [2, 0, 1, 1, 2, 6, 2, 2, 2],
    [2, 0, 1, 0, 2, 6, 2, 4, 2],
    [2, 2, 2, 0, 2, 2, 2, 4, 2],
    [6, 2, 2, 0, 0, 0, 0, 4, 2],
    [6, 2, 0, 0, 0, 2, 0, 0, 2],
    [6, 2, 0, 0, 0, 2, 2, 2, 2],
    [6, 2, 2, 2, 2, 2, 6, 6, 6]
    ],
    "mario": {
      "x": 3,
      "y": 1
    },
    "target": [[7, 4], [7, 3], [7, 5]]
  },
  {
    "map": [
    [6, 2, 2, 2, 2, 6, 6, 6, 6],
    [2, 2, 0, 0, 2, 6, 6, 6, 6],
    [2, 0, 3, 1, 2, 6, 6, 6, 6],
    [2, 2, 1, 0, 2, 2, 6, 6, 6],
    [2, 2, 0, 1, 0, 2, 6, 6, 6],
    [2, 4, 1, 0, 0, 2, 6, 6, 6],
    [2, 4, 4, 5, 4, 2, 6, 6, 6],
    [2, 2, 2, 2, 2, 2, 6, 6, 6],
    [6, 6, 6, 6, 6, 6, 6, 6, 6]
  ],
    "mario": {
      "x": 2,
      "y": 2
    },
    "target": [[1, 5], [1, 6], [2, 6], [3, 6], [4, 6]]
  },
  {
    "map": [
    [6, 2, 2, 2, 2, 2, 6, 6, 6],
    [6, 2, 3, 0, 2, 2, 2, 6, 6],
    [6, 2, 0, 1, 0, 0, 2, 6, 6],
    [2, 2, 2, 0, 2, 0, 2, 2, 6],
    [2, 4, 2, 0, 2, 0, 0, 2, 6],
    [2, 4, 1, 0, 0, 2, 0, 2, 6],
    [2, 4, 0, 0, 0, 1, 0, 2, 6],
    [2, 2, 2, 2, 2, 2, 2, 2, 6],
    [6, 6, 6, 6, 6, 6, 6, 6, 6]
  ],
    "mario": {
      "x": 2,
      "y": 1
    },
    "target": [[1, 4], [1, 5], [1, 6]]
}
]